MODE 0
SIZE 11/30
LIMIT 0/30
COLOR LIMIT 5
STARS 1150/2300/3900
1 1 2 2 3 3 4 4 5 5 5
0 2 2 3 3 4 4 5 5 0 0
0 3 3 4 4 5 5 1 1 1 0
2 2 0 0 0 0 0 0 1 1 0
0 2 2 0 0 0 0 0 3 3 0
0 2 2 0 0 0 0 3 3 0 0
0 0 4 4 0 0 0 3 3 0 0
0 0 4 4 0 0 5 5 0 0 0
0 0 0 4 4 0 5 5 0 0 0
1 1 2 2 3 3 4 4 5 5 0
0 1 2 0 3 3 4 0 5 5 0
0 0 0 0 0 0 0 0 0 0 0
0 0 0 0 0 0 0 0 0 0 0
0 0 0 0 0 0 0 0 0 0 0
0 0 0 0 0 0 0 0 0 0 0
0 0 0 0 0 0 0 0 0 0 0
0 0 0 0 0 0 0 0 0 0 0
0 0 0 0 0 0 0 0 0 0 0
0 0 0 0 0 0 0 0 0 0 0
0 0 0 0 0 0 0 0 0 0 0
0 0 0 0 0 0 0 0 0 0 0
0 0 0 0 0 0 0 0 0 0 0
0 0 0 0 0 0 0 0 0 0 0
0 0 0 0 0 0 0 0 0 0 0
0 0 0 0 0 0 0 0 0 0 0
0 0 0 0 0 0 0 0 0 0 0
0 0 0 0 0 0 0 0 0 0 0
0 0 0 0 0 0 0 0 0 0 0
0 0 0 0 0 0 0 0 0 0 0
0 0 0 0 0 0 0 0 0 0 0