MODE 0
SIZE 11/30
LIMIT 0/60
COLOR LIMIT 5
STARS 1050/2100/3600
1 1 1 2 2 2 3 3 3 4 4
1 1 2 2 2 3 3 0 4 4 4
1 1 1 2 2 0 0 3 3 3 4
5 5 5 2 2 0 0 0 3 3 4
5 5 5 0 0 0 0 4 4 4 4
5 5 5 5 0 0 0 0 0 4 4
0 1 1 2 2 2 0 0 0 0 0
0 0 0 0 0 2 3 3 3 0 0
0 0 0 0 0 0 4 4 4 0 0
0 0 0 0 0 0 0 0 0 0 0
0 0 0 0 0 0 0 0 0 0 0
0 0 0 0 0 0 0 0 0 0 0
0 0 0 0 0 0 0 0 0 0 0
0 0 0 0 0 0 0 0 0 0 0
0 0 0 0 0 0 0 0 0 0 0
0 0 0 0 0 0 0 0 0 0 0
0 0 0 0 0 0 0 0 0 0 0
0 0 0 0 0 0 0 0 0 0 0
0 0 0 0 0 0 0 0 0 0 0
0 0 0 0 0 0 0 0 0 0 0
0 0 0 0 0 0 0 0 0 0 0
0 0 0 0 0 0 0 0 0 0 0
0 0 0 0 0 0 0 0 0 0 0
0 0 0 0 0 0 0 0 0 0 0
0 0 0 0 0 0 0 0 0 0 0
0 0 0 0 0 0 0 0 0 0 0
0 0 0 0 0 0 0 0 0 0 0
0 0 0 0 0 0 0 0 0 0 0
0 0 0 0 0 0 0 0 0 0 0
0 0 0 0 0 0 0 0 0 0 0
0 0 0 0 0 0 0 0 0 0 0