MODE 0
SIZE 11/30
LIMIT 0/30
COLOR LIMIT 3
STARS 666/1333/2250
3 1 5 1 3 5 5 3 5 1 3
3 1 5 5 3 5 3 5 1 3 0
0 5 3 1 5 3 3 1 3 5 3
5 3 1 5 3 0 3 1 3 5 0
2 1 4 1 3 0 0 3 4 1 2
2 1 4 4 3 0 3 4 1 2 0
2 4 2 1 4 3 3 1 2 4 2
4 2 1 4 3 0 3 1 2 4 0
0 0 0 0 0 0 0 0 0 0 0
0 0 0 0 0 0 0 0 0 0 0
0 0 0 0 0 0 0 0 0 0 0
0 0 0 0 0 0 0 0 0 0 0
0 0 0 0 0 0 0 0 0 0 0
0 0 0 0 0 0 0 0 0 0 0
0 0 0 0 0 0 0 0 0 0 0
0 0 0 0 0 0 0 0 0 0 0
0 0 0 0 0 0 0 0 0 0 0
0 0 0 0 0 0 0 0 0 0 0
0 0 0 0 0 0 0 0 0 0 0
0 0 0 0 0 0 0 0 0 0 0
0 0 0 0 0 0 0 0 0 0 0
0 0 0 0 0 0 0 0 0 0 0
0 0 0 0 0 0 0 0 0 0 0
0 0 0 0 0 0 0 0 0 0 0
0 0 0 0 0 0 0 0 0 0 0
0 0 0 0 0 0 0 0 0 0 0
0 0 0 0 0 0 0 0 0 0 0
0 0 0 0 0 0 0 0 0 0 0
0 0 0 0 0 0 0 0 0 0 0
0 0 0 0 0 0 0 0 0 0 0
